0000000000000000000000000000000
0111111111111111111111001001110
0100000000001000000001111001010
0101111000001011111100100000010
0111001001101010000100100000010
0000001000101011101110111111110
0111111111101000101010100000000
0100010000001111101011111111110
0001000101111000001010000000010
0111111101000011111011101111010
0100000101111010000000101001010
0111011101000010011111101000010
0001010001011111110001001001110
0111011111110001000001111101000
0100000000010101110000000101000
0111111111111101011111111111000
0000000000000001000000000000000