0000000000000000000000000000000
0011110010011111100111111111100
0110010010010100100101002000100
0010010111121122111111002000100
0111211121111100100001001110100
0121110010111001110111111011100
0010111110000111001000100111000
0110100011111101111100100100000
0100100000000001000110100200000
0112111111111001000011111111100
0010012111111111000100000000100
0011111000100000011101111101100
0010002111101111110111010101000
0011111000111111110002101111000
0120101111100001011100101000000
0112100000000001000111111000000
0000000000000001000000000000000